.HHOHHHHHHHHHHHHHHH.
VC..H..V.T..H...M.CV
VE.....V...........V
VHHH.HHHHHHHHHH..V
V...............VH.V
V.............PCV..V
V.HHHHHHHHHHHHHHH.HV
V.HTTTTV....H......V
V.HTHTL...H...H.H..V
V.HHHHHHHHHHHHHHH..V
VC................CV
.HHHHHHHHHHHHHHHHHH.